S.................
t.T.......eB......
###..bs..###.ss...
ss.h####.######...
###ec...h######...
#####....##tt##h..
#####h.Te######h..
...B..B########ssp
##################
##################