..................
tcs.......eB......
###..bsT.###.ss...
ess.####.######..s
###he...h######h##
#####....##tt##.##
#####h.Te######h..
S..b..B########.sp
##################
##################