########..........
########....B.....
......##...##.....
S.b.Te##..###...bc
###.####.h##.s.h##
###.####.###.#.s..
##......h###...#..
eet.s.s.###.sept..
###########.####..
###########.......
