..................
t.T.##...peB......
###..bs..###Sss...
ss.h####.######...
###ec###h######...
#####....##tt##h..
#####h.Te######h..
...B..B########ss.
##################
##################