##################
##..............##
#................#
#................#
#................#
#.......et..bB..p#
#S.###..###.##..##
##...............#
####..........####
##################
