..........p.......
..........####....
.....t..........#.
S.T.###.....te.h#.
###....secb.##....
.......####.......
..................
ssssssssssssssssss
##################
##################
