..................
..................
..................
..................
..................
..................
..................
.............c....
..........s..#....
##################