##################
##################
##...#######..ec##
##S..e........####
#######.ssT.bh####
#############.e.##
##...########.#.##
##pe....t..e...b##
##################
##################
