..................
b..S...........T.c.
####h...eT....####
####es.h##h.eh####
..####......####..
..####t....b####..
....###s..s###....
....####pe####....
......######......
.......####.......
