..................
..................
..................
..................
..................
..................
..................
..................
sS.s.........cs..s
##################