..................
..................
..................
..................
..................
..................
..................
.............c....
.S........s..#....
##################