..................
..................
......s..###.ss...
ss..####.######...
###......######...
#####....##..##...
#####....######...
.......########ssp
##################
##################