..................
tST.......eB......
###..bs..###.ss...
ss.h####.######...
###e....h######...
#####....##tt##h..
#####h.Te######h..
...B..B########ssp
##################
##################