..................
..........e.......
......s..###.ss...
ss..####.######...
###e.....######...
#####....##..##...
#####...e######...
.......########ssp
##################
##################