##########
#........#
#........#
#........#
#........#
#........#
D........#
##########