##################
##..............##
#................#
#................#
#................#
#................#
#................#
##...............#
####..........####
##################
