####D####
#.......#
D.......#
#.......#
#.......#
#.......#
#########