.............#...#
.............#...#
.............#...#
........####.#...#
........######...#
#.......####.#...#