...#D#...
...#.#...
...#.#...
####.####
D.......D
####.####
...#.#...
...#.#...
...#D#...
