#########
#.......#
#.......#
#.......#
#.......###
#...@.....D
###########