........#.........
......s.#.........
....s########.....
..############....
.#####.###..##....
...##.............
..................
...s........ss....
##################
##################
